12 12 12 12 12 12 12 12 12 12 12 12 12 12 12 12 12 12 12 12 12 12 12 12 12 12 12 12 12 12 12 12 12 12 12 12 12 12 12 12 12 12 12 12 12 12 12 12 12 12 
12 12 12 12 12 12 12 12 12 12 12 12 12 12 13 12 12 12 12 12 12 12 12 12 12 12 12 12 12 12 12 12 12 12 12 12 12 12 12 12 12 12 12 12 12 12 12 12 12 12 
12 12 12 12 12 12 12 13 12 12 12 12 12 12 12 12 12 12 12 12 12 12 12 12 12 13 12 12 12 12 12 12 12 13 12 12 12 12 12 12 12 12 12 12 12 12 12 12 12 12 
12 12 12 12 13 12 12 12 12 12 12 13 12 12 12 12 12 12 13 12 12 12 12 12 12 12 12 13 12 12 12 12 12 12 12 12 12 12 12 12 12 13 12 12 12 12 12 12 12 12  
12 12 12 12 12 12 12 12 12 13 12 12 12 12 12 13 12 12 12 12 12 12 12 13 12 12 12 12 12 12 12 13 12 12 13 12 12 12 13 12 12 12 12 12 12 12 12 12 12 12 
12 12 12 12 12 12 12 12 12 12 12 12 12 12 12 12 12 12 12 12 12 13 12 12 12 12 12 12 12 13 12 12 12 12 12 12 13 12 12 12 12 12 12 13 12 12 12 12 12 12  
12 12 12 12 12 13 22 20 20 20 20 20 20 20 23 12 12 12 22 20 20 20 20 20 20 20 20 23 12 12 12 22 20 20 20 20 20 20 20 20 20 20 23 12 12 12 12 12 12 12 
12 12 12 12 12 12 18 41 41 41 41 41 41 41 19 20 20 20 21 41 10 10 11 10 10 10 10 19 20 20 20 21 41 10 10 10 10 11 11 10 10 11 17 12 12 13 12 12 12 12 
12 12 13 12 12 12 18 41 41 41 41 41 41 41 41 41 41 41 41 41 10 41 41 41 41 41 41 41 41 41 41 41 10 10 10 10 11 10 10 10 11 10 17 12 12 12 12 12 12 12 
12 12 12 12 12 12 12 41 41 41 41 41 41 41 41 41 41 41 41 41 41 41 41 41 41 41 41 41 41 41 41 41 10 10 11 41 41 41 41 10 11 10 17 12 12 12 12 12 12 12
12 12 12 12 12 12 12 41 41 41 41 41 41 41 41 41 41 41 41 41 41 41 41 41 41 41 41 41 41 41 41 41 41 10 11 41 41 41 41 10 11 10 17 12 12 12 12 12 12 12
12 12 12 12 12 12 12 41 41 41 41 41 41 41 41 41 41 41 41 41 41 41 41 41 41 41 41 41 41 41 41 41 41 10 11 41 41 41 41 41 41 41 17 12 12 12 12 12 12 12
12 12 12 12 12 12 12 41 41 41 41 41 41 41 41 41 41 41 41 41 41 41 41 41 41 41 41 41 41 41 41 41 41 10 11 41 41 41 41 41 41 41 17 12 12 12 12 12 12 12
12 12 12 12 12 12 12 41 41 41 41 41 10 10 10 10 10 10 41 41 41 41 41 41 41 41 41 41 41 41 41 41 41 10 11 41 41 41 41 41 41 41 17 12 12 12 12 12 12 12
12 12 12 12 12 12 12 41 41 41 41 41 10 10 10 10 10 10 41 41 41 41 41 41 41 41 41 41 41 41 41 41 41 10 11 41 41 41 41 41 41 41 17 12 12 12 12 12 12 12
12 12 12 12 12 12 12 41 41 41 41 41 10 10 10 10 10 10 41 41 41 41 41 41 41 41 41 41 10 10 10 10 11 10 11 11 10 10 10 41 41 41 17 12 12 12 12 12 12 12
12 12 12 12 12 12 12 41 41 41 41 41 41 11 11 11 10 11 41 41 41 41 41 41 41 41 41 41 10 11 10 10 11 10 11 10 11 10 11 41 41 41 17 12 12 12 12 12 12 12
12 12 12 12 12 12 12 41 41 41 41 41 10 11 10 10 10 11 10 10 10 11 10 11 10 11 10 10 10 10 10 10 11 10 11 10 10 10 11 41 41 41 17 12 12 12 12 12 12 12
12 12 12 12 12 12 12 41 41 41 41 41 10 11 10 10 10 10 41 41 41 41 41 41 41 41 41 41 10 10 10 10 11 10 11 10 10 11 10 41 41 41 17 12 12 12 12 12 12 12
12 12 12 12 12 12 12 41 41 41 41 41 10 10 11 10 10 10 41 41 41 41 41 41 41 41 41 41 41 11 10 10 10 11 10 11 10 10 11 41 41 41 17 12 12 12 12 12 12 12
12 12 12 12 12 12 12 41 41 41 41 41 10 10 10 11 10 10 41 41 41 41 41 41 41 41 41 41 41 41 41 41 41 10 10 41 41 41 41 41 41 41 17 12 12 12 12 12 12 12
12 12 12 12 12 12 12 41 41 41 41 41 41 41 41 41 41 41 41 41 41 41 41 41 41 41 41 41 41 41 41 41 41 11 10 41 41 41 41 41 41 41 17 12 12 12 12 12 12 12
12 12 12 12 12 12 12 41 41 41 41 41 41 41 41 41 41 41 41 41 41 41 41 41 41 41 41 41 41 11 41 41 41 11 10 41 41 41 41 41 41 41 17 12 12 12 12 12 12 12
12 12 12 12 12 12 12 41 41 41 41 41 41 41 41 41 41 41 41 41 41 41 41 41 41 41 41 41 41 10 11 10 11 10 10 41 41 41 41 41 41 41 17 12 12 12 12 12 12 12
12 12 12 12 12 12 12 41 41 41 41 41 41 41 41 41 41 41 41 41 41 41 41 41 41 41 41 41 41 10 10 41 41 10 11 41 41 41 41 41 41 41 17 12 12 12 12 12 12 12
12 12 12 12 12 12 12 41 41 41 41 41 41 41 41 41 41 41 41 41 41 41 41 41 41 41 41 41 41 10 10 41 41 10 10 41 41 41 41 41 41 41 17 12 12 12 12 12 12 12
12 12 12 12 12 12 12 41 41 41 41 41 41 41 41 41 41 41 41 41 41 41 41 41 41 41 41 41 41 10 11 41 41 11 11 41 41 41 41 41 41 41 17 12 12 12 12 12 12 12
12 12 12 12 12 12 12 41 41 41 41 41 41 41 41 41 41 41 41 41 41 41 41 41 41 41 41 41 41 11 10 41 41 10 10 41 41 41 41 41 41 41 17 12 12 12 12 12 12 12
12 12 12 12 12 12 12 41 41 41 41 41 41 41 41 41 41 41 41 41 41 41 41 41 41 41 41 41 41 41 10 10 10 10 10 41 41 41 41 41 41 41 17 12 12 12 12 12 12 12
12 12 12 12 12 12 12 41 41 41 41 41 41 41 41 41 41 41 41 41 41 41 41 41 41 41 41 41 41 41 41 41 41 11 11 41 41 41 41 41 41 41 17 12 12 12 12 12 12 12
12 12 12 12 12 12 12 41 41 41 41 41 41 41 41 41 41 41 41 41 41 41 41 41 41 41 41 41 41 41 41 41 41 10 10 41 41 41 41 41 41 41 17 12 12 12 12 12 12 12
12 12 12 12 12 12 12 41 41 41 41 41 41 41 41 41 41 41 41 41 41 41 41 41 41 41 41 41 41 41 41 41 41 41 41 41 41 41 41 41 41 41 17 12 12 12 12 12 12 12
12 12 12 12 12 12 12 41 41 41 41 41 41 41 41 41 41 41 41 41 41 41 41 41 41 41 41 41 41 41 41 41 41 41 41 41 41 41 41 41 41 41 17 12 12 12 12 12 12 12
12 12 12 12 12 12 12 41 41 41 41 41 41 41 41 41 41 41 41 41 41 41 41 41 41 41 41 41 41 41 41 41 41 41 41 41 41 41 41 41 41 41 17 12 12 12 12 12 12 12
12 12 12 12 12 12 12 41 41 41 41 41 41 41 41 41 41 41 41 41 41 41 41 41 41 41 41 41 41 41 41 41 41 41 41 41 41 41 41 41 41 41 17 12 12 12 12 12 12 12
12 12 12 12 12 12 12 41 41 41 41 41 41 41 41 41 41 41 41 41 41 41 41 41 41 41 41 41 41 41 41 41 41 41 41 41 41 41 41 41 41 41 17 12 12 12 12 12 12 12
12 12 12 12 12 12 12 41 41 41 41 41 41 41 41 41 41 41 41 41 41 41 41 41 41 41 41 41 41 41 41 41 41 41 41 41 41 41 41 41 41 41 17 12 12 12 12 12 12 12
12 12 12 12 12 12 12 41 41 41 41 41 41 41 41 41 41 41 41 41 41 41 41 41 41 41 41 41 41 41 41 41 41 41 41 41 41 41 41 41 41 41 17 12 12 12 12 12 12 12
12 12 12 12 12 12 12 41 41 41 41 41 41 41 41 41 41 41 41 41 41 41 41 41 41 41 41 41 41 41 41 41 41 41 41 41 41 41 41 41 41 41 17 12 12 12 12 12 12 12
12 12 12 12 12 12 12 41 41 41 41 41 41 41 41 41 41 41 41 41 41 41 41 41 41 41 41 41 41 41 41 41 41 41 41 41 41 41 41 41 41 41 17 12 12 12 12 12 12 12
12 12 12 12 12 12 12 41 41 41 41 41 41 41 41 41 41 41 41 41 41 41 41 41 41 41 41 41 41 41 41 41 41 41 41 41 41 41 41 41 41 41 17 12 12 12 12 12 12 12
12 12 12 12 12 12 12 41 41 41 41 41 41 41 41 41 41 41 41 41 41 41 41 41 41 41 41 41 41 41 41 41 41 41 41 41 41 41 41 41 41 41 17 12 12 12 12 12 12 12
12 12 12 12 12 12 12 41 41 41 41 41 41 41 41 41 41 41 41 41 41 41 41 41 41 41 41 41 41 41 41 41 41 41 41 41 41 41 41 41 41 41 17 12 12 12 12 12 12 12
12 12 12 12 12 12 12 41 41 41 41 41 41 41 41 41 41 41 41 41 41 41 41 41 41 41 41 41 41 41 41 41 41 41 41 41 41 41 41 41 41 41 17 12 12 12 12 12 12 12
12 12 12 12 12 12 12 41 41 41 41 41 41 41 41 41 41 41 41 41 41 41 41 41 41 41 41 41 41 41 41 41 41 41 41 41 41 41 41 12 12 12 17 12 12 12 12 12 12 12
12 12 12 12 12 12 12 41 41 41 41 41 41 41 41 41 41 41 41 41 41 41 41 41 41 41 41 41 41 41 41 41 41 41 41 41 41 41 41 12 12 12 17 12 12 12 12 12 12 12
12 12 12 12 12 12 12 41 41 41 41 41 41 41 41 41 41 41 41 41 41 41 41 41 41 41 41 41 41 41 41 41 41 41 41 41 41 41 41 12 12 12 17 12 12 12 12 12 12 12
12 12 12 12 12 12 12 41 41 41 41 41 41 41 41 41 41 41 41 41 41 41 41 41 41 41 41 41 41 41 41 41 41 41 41 41 41 41 41 12 12 12 17 12 12 12 12 12 12 12
12 12 12 12 12 12 12 41 41 41 41 41 41 41 41 41 41 41 41 41 41 41 41 41 41 41 41 41 41 41 41 41 41 41 41 41 41 41 41 12 12 12 17 12 12 12 12 12 12 12
12 12 12 12 12 12 12 12 12 12 12 12 12 12 12 12 12 12 12 12 12 12 12 12 12 12 12 12 12 12 12 12 12 12 12 12 12 12 12 12 12 12 17 12 12 12 12 12 12 12